135 25
31 31 31 31 31 31 31 31 31 31 31 31 31 31 31 31 31 31 31 31 31 31 31 31 31 31 31 31 31 31 31 31 31 31 31 31 31 31 31 31 31 31 31 31 31 31 31 31 31 31 31 31 31 31 31 31 31 31 31 31 31 31 31 31 31 31 31 31 31 31 31 31 31 31 31 31 31 31 31 31 31 31 31 31 31 31 31 31 31 31 31 31 31 31 31 31 31 31 31 31 31 31 31 31 31 31 31 31 31 31 31 31 31 31 31 31 31 31 31 31 31 31 31 -1 -1 -1 -1 -1 -1 -1 -1 -1 -1 -1 -1
31 31 31 31 31 31 31 31 31 31 31 31 31 31 31 31 31 31 31 31 31 31 31 31 31 31 31 31 31 31 31 31 31 31 31 31 31 31 31 31 31 31 31 31 31 31 31 31 31 31 31 31 31 31 31 31 31 31 31 31 31 31 31 31 31 31 31 31 31 31 31 31 31 31 31 31 31 31 31 31 31 31 31 31 31 31 31 31 31 31 31 31 31 31 31 31 31 31 31 31 31 31 31 31 31 31 31 31 31 31 31 31 31 31 31 31 31 31 31 31 31 31 31 31 31 31 31 31 31 31 31 31 31 31 31
31 31 31 31 31 31 31 31 31 31 31 31 31 31 31 31 31 31 31 31 31 31 31 31 31 31 31 31 31 31 31 31 31 31 31 31 31 31 31 31 31 31 31 31 31 31 31 31 31 31 31 31 31 31 31 31 31 31 31 31 31 31 31 31 31 31 31 31 31 31 31 31 31 31 31 31 31 31 31 31 31 31 31 31 31 31 31 31 31 31 31 31 31 31 31 31 31 31 31 31 31 31 31 31 31 31 31 31 31 31 31 31 31 31 31 31 31 31 31 31 31 31 31 31 31 31 31 31 31 31 31 31 31 31 31
31 31 31 31 31 31 31 31 31 31 31 31 31 31 31 31 31 31 31 31 31 31 31 31 31 31 31 31 31 31 31 31 31 31 31 31 31 31 31 31 31 31 31 31 31 31 31 31 31 31 31 31 31 31 31 31 31 31 31 31 31 31 31 31 31 31 31 31 31 31 31 31 31 31 31 31 31 31 31 31 31 31 31 31 31 31 31 31 31 31 31 31 31 31 31 31 31 31 31 31 31 31 31 31 31 31 31 31 31 31 31 31 31 31 31 31 31 31 31 31 31 31 31 31 31 31 31 31 31 31 31 31 31 31 31
31 31 31 31 31 31 31 31 31 31 31 31 31 31 31 31 31 31 31 31 31 31 31 31 31 31 31 31 31 31 31 31 31 31 31 31 31 31 31 31 31 31 31 31 31 31 31 31 31 31 31 31 31 31 31 31 31 31 31 31 31 31 31 31 31 31 31 31 31 31 31 31 31 31 31 31 31 31 31 31 31 31 31 31 31 31 31 31 31 31 31 31 31 31 31 31 31 31 31 31 31 31 31 31 31 31 31 31 31 31 31 31 31 31 31 31 31 31 31 31 31 31 31 31 31 31 31 31 31 31 31 31 31 31 31
31 31 31 31 31 31 31 31 31 31 31 31 31 31 31 31 31 31 31 31 31 31 31 31 31 31 31 31 31 31 31 31 31 31 31 31 31 31 31 31 31 31 31 31 31 31 31 31 31 31 31 31 31 31 31 31 31 31 31 31 31 31 31 31 31 31 31 31 31 31 31 31 31 31 31 31 31 31 31 31 31 31 31 31 31 31 31 31 31 31 31 31 31 31 31 31 31 31 31 31 31 31 31 31 31 31 31 31 31 31 31 31 31 31 31 31 31 31 31 31 31 31 31 31 31 31 31 31 31 31 31 31 31 31 31
31 31 31 31 31 31 31 31 31 31 31 31 31 31 31 31 31 31 31 31 31 31 31 31 31 31 31 31 31 31 31 31 31 31 31 31 31 31 31 31 31 31 31 31 31 31 31 31 31 31 31 31 31 31 31 31 31 31 31 31 31 31 31 31 31 31 31 31 31 31 31 31 31 31 31 31 31 31 31 31 31 31 31 31 31 31 31 31 31 31 31 31 31 31 31 31 31 31 31 31 31 31 31 31 31 31 31 31 31 31 31 31 31 31 31 31 31 31 31 31 31 31 31 31 31 31 31 31 31 31 31 31 31 31 31
31 31 31 31 31 31 31 31 31 31 31 31 31 31 31 31 31 31 31 31 31 31 31 31 31 31 31 31 31 31 31 31 31 31 31 31 31 31 31 31 34 31 31 31 31 31 31 31 31 31 31 31 31 31 31 31 31 31 31 31 31 31 31 31 31 31 31 31 31 31 31 31 31 31 31 31 31 31 31 31 31 31 31 31 31 31 31 31 31 31 31 34 31 31 31 31 31 31 31 31 31 31 31 31 31 31 31 31 31 31 31 31 31 31 31 31 31 31 31 31 31 31 31 31 31 31 31 31 31 31 31 31 31 31 31
31 31 31 31 31 31 31 31 31 31 31 31 31 31 31 31 31 31 31 31 31 31 31 31 31 31 31 31 31 31 33 33 33 33 33 31 31 31 31 31 31 31 31 31 31 33 33 33 33 33 31 31 31 31 31 31 31 31 31 31 31 31 31 31 31 31 31 31 31 31 31 31 31 31 31 31 31 31 31 31 31 31 31 31 38 31 31 31 31 31 31 31 31 31 31 31 31 31 31 31 31 31 31 31 31 31 31 31 31 31 31 31 31 31 31 31 31 31 31 31 31 31 31 31 31 31 31 31 31 31 31 31 31 31 31
31 31 31 31 31 31 31 31 31 31 31 31 31 31 34 31 31 31 31 31 31 31 31 31 31 31 31 31 31 31 33 33 33 33 33 31 31 31 31 31 31 31 31 31 31 33 33 33 33 33 31 31 31 31 31 31 31 31 31 31 31 31 31 31 31 31 31 31 31 31 31 31 31 31 31 31 31 31 31 31 31 31 31 38 38 38 31 31 31 31 31 31 31 31 31 31 31 31 31 38 31 31 31 31 31 31 31 31 31 31 31 31 31 31 31 31 31 31 31 31 31 31 31 31 31 31 31 31 31 31 31 31 31 31 31
31 31 31 31 31 31 31 31 33 33 31 31 31 31 31 31 31 31 33 33 31 31 31 31 31 31 31 31 31 31 31 31 31 31 31 31 31 31 31 31 31 31 31 31 31 31 31 31 31 31 31 31 31 31 31 31 31 31 31 31 31 31 31 31 31 31 31 31 31 31 31 31 31 31 31 31 31 31 31 31 31 40 39 38 38 38 31 31 31 31 31 31 31 31 31 31 31 31 38 38 38 31 31 31 31 31 31 31 31 31 31 31 31 31 31 31 31 31 31 31 31 31 31 31 31 31 31 31 31 31 31 31 31 31 31
31 31 31 31 31 31 31 31 33 33 31 31 31 31 31 31 31 31 33 33 31 31 31 31 31 31 31 31 31 31 31 31 31 31 31 31 31 31 31 31 31 31 31 31 31 31 31 31 31 31 31 31 31 31 31 31 31 31 31 31 31 31 31 31 31 31 31 31 31 31 31 31 31 31 31 31 31 31 31 31 31 31 31 38 38 38 39 41 31 31 31 31 31 31 31 31 31 38 38 38 38 38 39 39 39 41 31 31 31 31 31 31 31 31 31 31 31 31 31 31 31 31 51 31 31 31 31 31 31 31 31 31 31 31 31
31 31 31 31 31 31 31 12 12 12 12 31 31 31 31 31 31 12 12 12 12 31 31 31 31 31 31 31 31 31 31 31 31 31 31 31 35 36 36 36 36 36 36 35 31 31 31 31 31 31 31 31 31 31 31 31 31 31 31 31 31 33 33 33 33 31 31 31 34 31 31 31 33 33 33 33 33 31 31 31 31 31 31 38 38 38 31 31 31 31 31 31 31 31 31 31 31 38 38 38 38 38 31 31 31 31 31 31 31 31 31 31 31 31 34 31 31 31 33 33 33 31 52 31 31 31 31 31 31 31 33 33 31 31 31
31 31 31 31 31 31 31 31 31 31 31 31 31 31 31 31 31 31 31 31 31 31 31 31 31 31 31 31 31 31 31 31 31 31 31 31 37 31 31 31 31 31 31 37 31 31 31 31 31 31 31 31 31 31 31 31 31 31 31 31 31 33 33 33 33 31 31 31 31 31 31 31 33 33 33 33 33 31 31 31 31 31 31 38 42 38 31 31 31 31 33 33 33 31 31 40 39 38 38 38 38 38 31 31 31 31 31 33 33 33 33 33 31 31 31 31 31 31 33 33 33 31 37 31 31 31 31 31 31 31 33 33 31 31 31
31 31 31 31 31 31 31 31 31 31 31 31 51 31 31 31 31 31 31 31 31 31 31 31 31 31 31 31 31 31 31 31 31 31 31 31 37 31 31 30 30 31 31 37 31 31 31 31 31 31 31 31 31 31 31 31 31 31 31 31 31 31 31 31 31 31 31 31 31 31 31 31 31 31 31 31 31 31 31 31 40 39 39 38 38 38 31 31 31 31 33 33 33 31 31 31 31 38 38 42 38 38 31 31 31 31 31 33 33 33 33 33 31 31 31 31 31 31 12 12 12 31 37 31 31 31 31 31 31 31 31 31 31 31 31
31 31 31 31 31 31 31 31 31 31 31 31 52 31 31 31 31 31 31 31 31 31 31 31 31 31 31 31 31 32 32 32 32 26 26 26 32 32 32 32 32 32 32 32 32 32 32 32 32 32 32 32 32 32 31 31 31 31 31 31 31 31 31 31 31 31 31 31 31 31 31 31 31 31 31 31 31 31 31 31 31 31 31 38 38 38 39 41 31 31 31 31 31 31 31 31 31 38 38 38 38 38 31 31 31 31 31 31 31 31 31 31 31 31 31 31 31 31 31 31 31 31 37 31 31 31 31 31 31 31 31 31 31 31 31
31 31 31 31 31 31 31 31 31 31 31 31 37 31 31 31 31 31 31 31 31 31 31 31 31 31 31 31 32 32 32 32 32 26 26 26 32 32 32 32 32 32 32 32 32 32 32 32 32 32 32 32 32 32 32 31 31 31 31 31 31 31 31 31 31 31 31 31 31 31 31 31 31 31 31 31 31 31 31 31 31 31 31 38 38 38 31 31 31 31 31 31 31 31 31 31 31 38 38 38 38 38 31 31 31 31 31 31 31 31 31 31 31 31 31 31 31 31 31 31 31 31 37 31 31 31 31 31 43 44 44 44 44 44 45
31 49 31 31 31 31 31 31 31 31 31 31 37 31 31 31 31 31 31 31 31 31 31 31 31 31 31 32 32 32 2 2 2 26 26 26 2 2 2 2 2 2 2 2 2 2 2 2 2 2 2 2 2 32 32 32 31 31 31 31 31 31 31 31 30 31 31 30 31 31 30 31 31 31 31 31 31 31 31 31 31 31 31 38 38 38 31 31 31 31 31 31 31 31 31 31 31 38 38 38 38 38 31 31 31 31 31 31 31 31 31 31 31 31 31 31 31 31 31 31 31 31 37 31 31 31 31 31 47 46 46 46 46 46 48
30 50 31 31 31 31 31 31 31 31 31 31 37 31 31 31 31 31 31 31 31 31 31 31 31 31 32 32 32 2 2 2 2 26 26 26 2 2 2 2 2 2 2 2 2 2 2 2 2 2 2 2 2 2 32 32 32 32 32 32 32 32 26 26 32 26 26 32 26 26 32 26 26 26 26 26 26 26 26 26 26 26 26 32 32 32 26 26 26 26 26 26 26 26 26 26 26 32 32 32 32 32 32 26 26 26 26 26 26 26 26 26 26 26 26 26 26 26 26 32 32 32 32 32 32 32 32 32 32 32 32 32 32 32 32
32 32 32 32 32 32 32 26 26 26 32 32 32 32 32 32 32 32 32 26 32 32 32 32 32 32 32 32 2 2 2 2 2 2 2 2 2 2 2 2 2 2 2 2 2 2 2 2 2 2 2 2 2 2 2 32 32 32 32 32 32 32 26 26 32 26 26 32 26 26 32 26 26 26 26 26 26 26 26 26 26 26 26 32 32 32 26 26 26 26 26 26 26 26 26 26 26 32 32 32 32 32 32 26 26 26 26 26 26 26 26 26 26 26 26 26 26 26 26 32 32 32 32 32 32 32 32 32 32 32 32 32 32 32 32
32 32 32 32 32 32 32 26 26 26 32 32 32 32 32 32 32 32 32 26 32 32 32 32 32 32 32 2 2 2 2 2 2 2 2 2 2 2 2 2 2 2 2 2 2 2 2 2 2 2 2 2 2 2 2 2 2 2 2 2 2 2 26 26 2 26 26 2 26 26 2 26 26 26 26 26 26 26 26 26 26 26 26 2 2 2 26 26 26 26 26 26 26 26 26 26 26 2 2 2 2 2 2 26 26 26 26 26 26 26 26 26 26 26 26 26 26 26 26 2 2 2 2 2 2 2 2 2 2 2 2 2 2 2 2
2 2 2 2 2 2 2 26 26 26 26 26 26 26 26 26 26 26 26 26 2 2 2 2 2 2 2 2 2 2 2 2 2 2 2 2 2 2 2 2 2 2 2 2 2 2 2 2 2 2 2 2 2 2 2 2 2 2 2 2 2 2 26 26 2 26 26 2 26 26 2 2 26 26 26 26 26 26 26 26 26 26 26 2 2 2 26 26 26 26 26 26 26 26 26 26 26 2 2 2 2 2 2 2 26 26 26 26 26 26 26 26 26 26 26 26 26 26 26 2 2 2 2 2 2 2 2 2 2 2 2 2 2 2 2
2 2 2 2 2 2 2 26 26 26 26 26 26 26 26 26 26 26 26 26 2 2 2 2 2 2 2 2 2 2 2 2 2 2 2 2 2 2 2 2 2 2 2 2 2 2 2 2 2 2 2 2 2 2 2 2 2 2 2 2 2 2 26 26 2 26 26 2 26 26 2 2 26 26 26 26 26 26 26 26 26 26 26 26 26 26 26 26 26 26 26 26 26 26 26 26 26 2 2 2 2 2 2 2 26 26 26 26 26 26 26 26 26 26 26 26 26 26 26 2 2 2 2 2 2 2 2 2 2 2 2 2 2 2 2
2 2 2 2 2 2 2 2 2 2 2 2 2 2 2 2 2 2 2 2 2 2 2 2 2 2 2 2 2 2 2 2 2 2 2 2 2 2 2 2 2 2 2 2 2 2 2 2 2 2 2 2 2 2 2 2 2 2 2 2 2 2 26 26 2 26 26 2 26 26 2 2 26 26 26 26 26 26 26 26 26 26 26 26 26 26 26 26 26 26 26 26 26 26 26 26 26 2 2 2 2 2 2 2 26 26 26 26 26 26 26 26 26 26 26 26 26 26 26 2 2 2 2 2 2 2 2 2 2 2 2 2 2 2 2
2 2 2 2 2 2 2 2 2 2 2 2 2 2 2 2 2 2 2 2 2 2 2 2 2 2 2 2 2 2 2 2 2 2 2 2 2 2 2 2 2 2 2 2 2 2 2 2 2 2 2 2 2 2 2 2 2 2 2 2 2 2 2 2 2 2 2 2 2 2 2 2 2 2 2 2 2 2 2 2 2 2 2 2 2 2 2 2 2 2 2 2 2 2 2 2 2 2 2 2 2 2 2 2 2 2 2 2 2 2 2 2 2 2 2 2 2 2 2 2 2 2 2 2 2 2 2 2 2 2 2 2 2 2 2