123 27
56 56 56 56 56 56 56 56 56 56 56 56 56 56 56 56 56 56 56 56 56 56 56 56 56 56 56 56 56 56 56 56 56 56 56 56 56 56 56 56 56 56 56 56 56 56 56 56 56 56 56 56 56 56 56 56 56 56 56 56 56 56 56 56 56 56 56 56 56 56 56 56 56 56 56 56 56 56 56 56 56 56 56 56 56 56 56 56 56 56 56 56 56 56 56 56 56 56 56 56 56 56 56 56 56 56 56 56 56 56 56 56 56 56 56 56 56 56 56 56 56 56 56
23 23 23 23 23 23 23 23 23 23 23 23 23 23 23 23 23 23 23 23 23 23 23 23 23 23 23 23 23 23 23 23 23 23 23 23 23 23 23 23 23 23 23 23 23 23 23 23 23 23 23 23 23 23 23 23 23 23 23 23 23 23 23 23 23 23 23 23 23 23 23 23 23 23 23 23 23 23 23 23 23 23 23 23 23 23 23 23 23 23 23 23 23 23 23 23 23 23 23 23 23 23 23 23 23 23 23 23 23 23 23 23 23 23 23 23 23 23 23 23 23 23 23
23 53 23 23 23 23 23 23 23 23 23 23 53 23 23 23 23 23 53 23 23 23 54 55 23 23 23 23 23 23 23 23 23 23 54 55 23 23 23 23 23 23 23 23 23 23 23 23 23 23 53 23 23 23 23 23 23 23 23 23 54 55 23 23 23 23 23 23 23 23 23 23 23 53 23 23 23 23 54 55 23 23 23 23 23 23 23 23 23 53 23 23 23 23 23 54 55 23 23 23 23 23 23 23 53 23 23 23 23 23 23 23 23 23 23 54 55 23 23 23 23 23 23
23 23 23 23 54 55 23 23 23 23 23 23 23 23 23 23 23 23 23 23 23 23 23 23 23 23 23 23 23 53 23 23 23 23 23 23 23 23 23 23 53 23 23 23 23 23 23 23 23 23 23 23 23 23 23 23 23 23 23 23 23 23 23 23 53 23 23 23 23 23 23 23 23 23 23 23 23 23 23 23 23 23 23 53 23 23 23 23 23 23 23 23 23 23 23 23 23 23 23 23 23 23 23 23 23 23 23 23 23 23 23 23 23 53 23 23 23 23 23 23 23 23 23
23 23 23 23 23 23 23 23 23 53 23 23 23 23 23 54 55 23 23 23 23 23 23 23 23 23 23 23 23 23 23 23 23 23 23 23 23 23 23 23 23 23 23 23 23 54 55 23 23 23 23 23 23 23 53 23 23 23 23 53 23 23 23 23 23 23 23 23 23 23 23 23 23 23 23 23 23 23 23 23 23 23 23 23 23 23 54 55 23 23 23 1 23 23 53 23 23 23 23 23 23 54 55 23 23 23 23 23 23 23 23 23 23 23 23 23 23 23 23 23 54 55 23
23 23 23 23 23 23 23 23 23 23 23 23 23 23 23 23 23 23 23 23 23 53 23 23 23 23 23 23 23 23 23 23 23 53 23 23 23 23 23 23 23 23 23 23 23 23 23 23 23 23 23 23 23 23 23 23 23 23 23 23 23 23 23 23 23 54 55 23 23 23 23 54 55 23 23 23 23 23 23 23 53 23 23 23 23 23 23 23 23 23 1 1 1 1 23 23 23 23 23 23 23 23 23 23 23 23 23 53 23 23 54 55 23 23 23 23 23 23 23 23 23 23 23
23 23 53 23 23 23 23 23 23 23 23 23 23 23 23 23 23 23 23 23 23 23 23 23 23 23 23 23 23 23 23 23 23 23 23 23 23 23 53 23 23 23 23 23 23 23 23 23 23 23 23 23 23 23 23 23 23 23 23 23 23 23 23 23 23 23 23 23 23 23 23 23 23 23 23 53 23 23 23 23 23 23 23 23 23 23 23 23 53 1 1 1 1 1 1 23 23 53 23 23 23 23 23 23 23 23 23 23 23 23 23 23 23 23 23 23 23 53 23 23 23 23 23
23 23 23 23 23 23 23 23 23 23 23 23 23 23 23 23 23 23 23 23 23 23 23 23 23 23 23 23 23 23 16 23 23 23 23 23 23 23 23 23 23 23 23 23 23 23 16 23 23 23 23 23 23 23 23 23 23 23 23 23 23 23 23 23 23 23 23 23 23 23 23 23 23 23 23 23 23 23 23 23 23 23 23 23 23 23 23 23 23 1 1 1 1 1 1 23 23 23 23 23 23 23 23 23 23 23 23 23 23 23 23 23 23 23 23 23 23 23 23 23 23 23 23
23 23 23 23 23 23 23 23 23 23 23 23 23 23 23 23 23 23 23 23 23 23 23 23 23 23 23 23 23 23 13 23 23 23 23 23 23 23 23 23 23 23 23 23 23 23 13 23 23 23 23 23 23 23 23 23 23 23 23 23 23 23 23 23 23 23 23 23 23 23 23 23 23 23 23 23 23 23 23 23 23 23 23 23 23 23 23 23 1 1 1 1 1 1 1 1 23 23 23 23 23 23 23 23 23 23 23 23 23 23 23 23 23 23 23 23 23 23 23 23 23 23 23
23 23 23 23 23 23 23 23 23 23 23 23 23 23 23 23 23 23 23 23 23 23 23 23 23 23 23 23 23 13 13 13 23 23 23 23 23 23 23 23 23 23 23 23 23 13 13 13 23 23 23 23 23 23 23 23 23 23 23 23 23 23 23 23 23 23 23 23 23 23 23 23 23 23 23 23 23 23 23 23 23 23 23 23 23 23 23 23 1 1 1 1 1 1 1 1 23 23 23 23 23 23 23 23 23 23 23 23 23 23 23 23 23 23 23 23 23 23 23 23 23 23 23
23 23 23 23 23 23 21 23 23 23 23 23 23 23 23 23 23 23 23 23 23 23 23 23 23 23 23 23 13 13 13 13 13 23 23 23 23 23 23 23 23 23 23 23 13 13 13 13 13 23 23 23 23 23 23 23 23 23 23 23 23 23 23 23 23 23 23 23 23 23 23 23 23 23 23 23 23 23 23 23 23 23 23 23 23 23 23 23 23 1 8 8 8 1 1 23 23 23 23 23 23 23 23 23 23 23 23 23 23 23 23 23 23 23 23 23 23 23 23 23 23 23 23
23 23 23 23 23 23 23 23 23 23 23 23 23 23 23 23 23 23 23 23 23 23 23 23 23 23 23 13 13 13 14 13 13 13 23 23 23 23 23 23 23 23 23 13 13 13 14 13 13 13 23 23 23 23 23 23 23 23 23 23 23 23 23 23 23 23 23 23 23 23 23 23 23 23 23 23 23 23 23 23 23 23 23 23 23 23 23 18 17 17 8 8 8 23 23 23 23 23 23 23 23 23 23 23 23 23 23 23 23 23 23 23 23 23 23 23 23 23 23 23 23 23 23
23 23 23 23 23 23 23 23 23 23 23 23 23 23 23 23 23 23 23 23 23 23 23 23 23 23 23 23 23 13 13 13 23 23 23 23 23 23 23 23 23 23 23 23 23 13 13 13 23 23 23 23 23 23 23 23 23 23 23 23 23 23 23 23 23 23 23 23 23 23 23 23 23 23 23 23 23 23 23 23 23 23 23 23 23 23 23 23 23 23 8 8 8 17 17 17 19 23 23 23 23 23 23 23 23 23 23 23 23 23 23 23 23 23 23 23 23 23 23 23 23 23 23
23 23 23 23 23 23 23 23 23 23 23 23 23 23 23 23 23 23 23 23 23 2 2 2 23 23 18 17 17 13 13 13 23 23 23 23 23 23 23 23 23 23 23 23 23 13 13 13 23 23 23 23 23 23 23 23 23 23 23 23 23 23 23 23 15 23 23 23 23 23 23 23 23 23 23 23 23 23 23 23 23 23 23 23 23 23 23 23 23 3 8 9 8 23 23 23 23 23 23 23 23 23 23 23 23 23 23 23 23 23 23 23 16 23 23 23 23 23 23 23 23 23 23
16 23 23 23 23 23 23 23 23 23 23 23 23 23 23 23 23 23 23 23 23 23 23 23 23 23 23 23 23 13 13 13 23 23 23 23 23 23 23 23 23 23 23 23 23 13 13 13 23 23 23 23 23 23 23 23 23 23 23 23 23 23 23 23 15 23 23 23 23 23 23 23 23 23 23 23 23 23 23 23 23 23 23 23 23 23 18 17 17 17 8 8 8 23 23 23 23 23 23 23 23 23 23 23 23 23 23 23 23 23 23 23 13 23 23 23 23 23 23 23 23 23 23
13 23 23 23 23 23 23 23 23 23 23 23 23 23 23 23 23 23 23 23 23 23 23 23 23 2 23 23 23 23 15 23 23 23 23 23 23 23 23 23 23 23 23 23 23 23 15 23 23 23 23 23 23 23 23 23 23 23 23 23 23 23 23 23 15 23 23 23 23 23 23 23 23 23 23 23 23 23 23 23 23 23 23 23 23 23 23 23 23 23 8 8 8 4 23 23 23 23 23 23 23 23 23 23 23 23 23 23 23 23 23 23 13 23 23 23 23 23 23 23 23 23 23
13 23 23 23 23 23 23 23 23 3 3 4 23 23 23 23 23 23 23 23 23 23 23 23 2 2 23 23 23 23 15 23 23 23 23 23 23 23 23 23 23 23 23 23 23 23 15 23 23 23 23 23 23 23 23 23 23 23 23 23 23 13 13 13 13 23 23 23 23 23 23 23 23 23 23 23 23 23 23 23 23 23 13 13 13 23 23 23 23 3 8 8 8 23 23 23 23 23 23 23 23 23 23 23 23 23 23 23 7 23 23 23 13 23 23 23 23 23 23 23 23 23 23
13 23 23 23 23 23 23 23 23 3 0 4 23 23 23 23 23 23 23 23 23 23 23 2 2 2 23 23 23 23 15 23 23 23 23 23 23 23 23 23 23 23 23 23 23 23 15 23 23 23 23 23 23 23 23 23 23 23 23 23 23 15 23 23 15 23 23 23 23 23 23 23 23 23 23 23 23 23 23 23 23 23 13 13 13 23 23 23 23 23 8 8 8 23 23 23 23 23 23 23 23 23 23 23 23 23 23 0 0 23 23 23 13 23 23 23 23 23 23 23 23 23 23
13 23 23 7 6 23 23 23 23 3 0 4 6 23 23 6 23 23 23 7 7 23 2 2 2 2 6 7 6 7 15 23 23 23 23 23 23 23 23 23 23 23 23 23 23 23 15 23 23 23 23 23 23 23 23 23 23 23 23 23 23 15 23 23 15 6 7 6 7 6 7 6 7 6 7 6 7 6 7 6 7 6 13 13 13 4 23 23 3 4 8 8 8 4 23 23 6 23 23 23 23 23 23 23 23 23 23 0 23 23 23 6 13 23 23 6 7 23 23 23 23 23 23
0 0 0 0 0 0 0 0 0 0 0 0 0 0 0 0 0 0 0 0 0 0 0 0 0 0 0 0 0 0 0 24 24 24 24 24 24 24 24 24 24 24 24 24 24 24 2 24 24 24 24 24 24 24 24 24 24 24 24 24 24 0 0 0 0 0 0 0 0 0 0 0 0 0 0 0 0 0 0 0 0 0 0 0 0 0 0 0 0 0 0 0 0 0 0 0 0 24 24 24 24 24 24 24 24 24 24 0 26 0 0 0 0 0 0 0 0 26 26 0 0 0 0
2 2 2 2 2 2 2 2 2 2 2 2 2 2 2 2 2 2 2 2 2 2 2 2 2 2 2 2 2 2 2 25 25 25 25 25 25 25 25 25 25 25 25 25 25 25 25 25 25 25 25 25 25 25 25 25 25 25 25 25 25 2 2 2 2 2 2 2 2 2 2 2 2 2 2 2 2 2 2 2 2 2 2 2 2 2 2 2 2 2 2 2 2 2 2 2 2 25 25 25 25 25 25 25 25 25 25 2 26 2 2 2 2 2 2 2 2 26 26 2 2 2 2
2 2 2 2 2 2 2 2 2 2 2 2 2 2 2 2 2 2 2 2 2 2 2 2 2 2 2 2 2 2 2 25 25 25 25 25 25 25 25 25 25 25 25 25 25 25 25 25 25 25 25 25 25 25 25 25 25 25 25 25 25 2 2 2 2 2 2 2 2 2 2 2 2 2 2 2 2 2 2 2 2 2 2 2 2 2 2 2 2 2 2 2 2 2 2 2 2 25 25 25 25 25 25 25 25 25 25 2 26 2 2 2 2 2 2 26 26 26 2 2 2 2 2
2 2 2 2 2 2 2 2 2 2 2 2 2 2 2 2 2 2 2 2 2 2 2 2 2 2 2 2 2 2 2 25 25 25 25 25 25 25 25 25 25 25 25 25 25 25 25 25 25 25 25 25 25 25 25 25 25 25 25 25 25 2 2 2 2 2 2 2 2 2 2 2 2 2 2 2 2 2 2 2 2 2 2 2 2 2 2 2 2 2 2 2 2 2 2 2 2 25 25 25 25 25 25 25 25 25 25 2 26 26 26 26 26 26 26 26 2 2 2 2 2 2 2
2 2 2 2 2 2 2 2 2 2 2 2 2 2 2 2 2 2 2 2 2 2 2 2 2 2 2 2 2 2 2 2 2 2 2 2 2 2 2 2 2 2 2 2 2 2 2 2 2 2 2 2 2 2 2 2 2 2 2 2 2 2 2 2 2 2 2 2 2 2 2 2 2 2 2 2 2 2 2 2 2 2 2 2 2 2 2 2 2 2 2 2 2 2 2 2 2 2 2 2 2 2 2 2 2 2 2 2 2 2 2 2 2 2 2 2 2 2 2 2 2 2 2
2 2 2 2 2 2 2 2 2 2 2 2 2 2 2 2 2 2 2 2 2 2 2 2 2 2 2 2 2 2 2 2 2 2 2 2 2 2 2 2 2 2 2 2 2 2 2 2 2 2 2 2 2 2 2 2 2 2 2 2 2 2 2 2 2 2 2 2 2 2 2 2 2 2 2 2 2 2 2 2 2 2 2 2 2 2 2 2 2 2 2 2 2 2 2 2 2 2 2 2 2 2 2 2 2 2 2 2 2 2 2 2 2 2 2 2 2 2 2 2 2 2 2
2 2 2 2 2 2 2 2 2 2 2 2 2 2 2 2 2 2 2 2 2 2 2 2 2 2 2 2 2 2 2 2 2 2 2 2 2 2 2 2 2 2 2 2 2 2 2 2 2 2 2 2 2 2 2 2 2 2 2 2 2 2 2 2 2 2 2 2 2 2 2 2 2 2 2 2 2 2 2 2 2 2 2 2 2 2 2 2 2 2 2 2 2 2 2 2 2 2 2 2 2 2 2 2 2 2 2 2 2 2 2 2 2 2 2 2 2 2 2 2 2 2 2
2 2 2 2 2 2 2 2 2 2 2 2 2 2 2 2 2 2 2 2 2 2 2 2 2 2 2 2 2 2 2 2 2 2 2 2 2 2 2 2 2 2 2 2 2 2 2 2 2 2 2 2 2 2 2 2 2 2 2 2 2 2 2 2 2 2 2 2 2 2 2 2 2 2 2 2 2 2 2 2 2 2 2 2 2 2 2 2 2 2 2 2 2 2 2 2 2 2 2 2 2 2 2 2 2 2 2 2 2 2 2 2 2 2 2 2 2 2 2 2 2 2 2