23 14
23 23 23 23 23 23 23 23 23 23 23 23 23 23 23 23 23 23 23 23 23 23 23
23 21 23 23 23 23 23 23 23 23 23 23 23 23 23 23 23 23 23 23 23 23 23
23 23 23 23 23 23 23 23 23 23 23 54 55 23 23 23 23 23 23 23 23 23 23
23 23 23 53 23 23 23 23 23 23 23 23 23 23 23 23 23 23 53 23 23 23 23
23 23 23 23 23 23 23 23 23 23 23 23 1 1 1 23 23 23 23 23 23 23 23
23 23 23 23 23 23 23 23 23 23 23 1 1 1 1 1 23 23 23 23 23 23 23
23 23 23 23 23 23 23 23 23 23 23 1 1 1 1 1 23 23 23 23 23 23 23
23 23 23 23 23 23 23 23 23 23 23 23 23 8 23 23 23 23 23 23 23 23 23
23 23 23 23 23 23 23 6 23 23 23 23 23 8 23 23 23 23 23 23 23 23 23
23 23 7 23 23 0 0 0 0 23 7 23 23 8 23 6 23 23 23 23 23 23 7
0 0 0 0 0 0 0 0 0 0 0 0 0 0 0 0 0 0 0 0 0 0 0
22 22 22 22 22 22 22 22 22 22 22 22 22 22 22 22 22 22 22 22 22 22 22
2 2 2 2 2 2 2 2 2 2 2 2 2 2 2 2 2 2 2 2 2 2 2
2 2 2 2 2 2 2 2 2 2 2 2 2 2 2 2 2 2 2 2 2 2 2